@..###
..##.#.####
.##..#X#..#
##........#
#..E...#..#
###..###..#
..#..#....#
.##.##.#.##
.#......##
.#.....##
.#######