..................................................................
................##@#....###..####..####...###.#########...........
................####....###..###..####...###..########............
...............#####...###..####.####..####..####.................
...............#####..####.####..###..###....###..................
..............######..###..###..########....####..................
.............###########..####..#######....#########..............
.............###########..###..########....########...............
............####.######..###..####.####...####....................
...........####..######.####..###..####..####.................###.
......#....###...#####..###..####..####..####.............#####...
.....##...####...####..####.####...####.##################........
....##...####....###...###..###....####.##############............
...###..................................#########.................
..####............................###########.....................
.######.....................#############.........................
.########.............###############.............................
.############..###################................................
.#############################....................................
.#########################........................................
.#####################............................................
.#################................................................
....########......................................................
..................................................................
..................................................................
